{
  "name": "BG Map Scene 2",
  "indices": [
    7, 7, 7, 7, 7, 7, 7, 7, 7, 7, 7,
    7, 2, 1, 2, 1, 2, 1, 2, 1, 2, 7,
    7, 1, 2, 1, 2, 1, 2, 1, 2, 1, 7,
    7, 2, 1, 2, 1, 2, 1, 2, 1, 2, 7,
    7, 1, 2, 1, 2, 1, 2, 1, 2, 1, 7,
    7, 2, 1, 2, 1, 2, 1, 2, 1, 2, 7,
    7, 1, 2, 1, 2, 1, 2, 1, 2, 1, 7,
    7, 2, 1, 2, 1, 2, 1, 2, 1, 2, 7,
    7, 1, 2, 1, 2, 1, 2, 1, 2, 1, 7,
    7, 2, 1, 2, 1, 2, 1, 2, 1, 2, 7,
    7, 1, 2, 1, 2, 1, 2, 1, 2, 1, 7,
    7, 7, 7, 7, 7, 7, 7, 7, 7, 7, 7
  ],
  "collision" : []
}