{
  "name": "BG Map Scene 0",
  "indices": [
    [3, 3, 3, 3, 3, 3, 3, 3, 3, 3, 3, 3, 3, 3, 3, 3, 3, 3, 3, 3, 3, 3, 3, 3, 3, 3, 3, 3, 3, 3, 3, 3, 3, 3, 3, 3, 3, 3, 3, 3],
    [3, 7, 5, 7, 5, 7, 5, 7, 5, 7, 5, 7, 5, 7, 5, 7, 5, 7, 5, 7, 5, 7, 5, 7, 5, 7, 5, 7, 5, 7, 5, 7, 5, 7, 5, 7, 5, 7, 5, 3],
    [3, 5, 7, 5, 7, 5, 7, 5, 7, 5, 7, 5, 7, 5, 7, 5, 7, 5, 7, 5, 7, 5, 7, 5, 7, 5, 7, 5, 7, 5, 7, 5, 7, 5, 7, 5, 7, 5, 7, 3],
    [3, 7, 5, 7, 5, 7, 5, 7, 5, 7, 5, 7, 5, 7, 5, 7, 5, 7, 5, 7, 5, 7, 5, 7, 5, 7, 5, 7, 5, 7, 5, 7, 5, 7, 5, 7, 5, 7, 5, 3],
    [3, 5, 7, 5, 7, 5, 7, 5, 7, 5, 7, 5, 7, 5, 7, 5, 7, 5, 7, 5, 7, 5, 7, 5, 7, 5, 7, 5, 7, 5, 7, 5, 7, 5, 7, 5, 7, 5, 7, 3],
    [3, 7, 5, 7, 5, 7, 5, 7, 5, 7, 5, 7, 5, 7, 5, 7, 5, 7, 5, 7, 5, 7, 5, 7, 5, 7, 5, 7, 5, 7, 5, 7, 5, 7, 5, 7, 5, 7, 5, 3],
    [3, 5, 7, 5, 7, 5, 7, 5, 7, 5, 7, 5, 7, 5, 7, 5, 7, 5, 7, 5, 7, 5, 7, 5, 7, 5, 7, 5, 7, 5, 7, 5, 7, 5, 7, 5, 7, 5, 7, 3],
    [3, 7, 5, 7, 5, 7, 5, 7, 5, 7, 5, 7, 5, 7, 5, 7, 5, 7, 5, 7, 5, 7, 5, 7, 5, 7, 5, 7, 5, 7, 5, 7, 5, 7, 5, 7, 5, 7, 5, 3],
    [3, 5, 7, 5, 7, 5, 7, 5, 7, 5, 7, 5, 7, 5, 7, 5, 7, 5, 7, 5, 7, 5, 7, 5, 7, 5, 7, 5, 7, 5, 7, 5, 7, 5, 7, 5, 7, 5, 7, 3],
    [3, 7, 5, 7, 5, 7, 5, 7, 5, 7, 5, 7, 5, 7, 5, 7, 5, 7, 5, 7, 5, 7, 5, 7, 5, 7, 5, 7, 5, 7, 5, 7, 5, 7, 5, 7, 5, 7, 5, 3],
    [3, 5, 7, 5, 7, 5, 7, 5, 7, 5, 7, 5, 7, 5, 7, 5, 7, 5, 7, 5, 7, 5, 7, 5, 7, 5, 7, 5, 7, 5, 7, 5, 7, 5, 7, 5, 7, 5, 7, 3],
    [3, 7, 5, 7, 5, 7, 5, 7, 5, 7, 5, 7, 5, 7, 5, 7, 5, 7, 5, 7, 5, 7, 5, 7, 5, 7, 5, 7, 5, 7, 5, 7, 5, 7, 5, 7, 5, 7, 5, 3],
    [3, 5, 7, 5, 7, 5, 7, 5, 7, 5, 7, 5, 7, 5, 7, 5, 7, 5, 7, 5, 7, 5, 7, 5, 7, 5, 7, 5, 7, 5, 7, 5, 7, 5, 7, 5, 7, 5, 7, 3],
    [3, 7, 5, 7, 5, 7, 5, 7, 5, 7, 5, 7, 5, 7, 5, 7, 5, 7, 5, 7, 5, 7, 5, 7, 5, 7, 5, 7, 5, 7, 5, 7, 5, 7, 5, 7, 5, 7, 5, 3],
    [3, 5, 7, 5, 7, 5, 7, 5, 7, 5, 7, 5, 7, 5, 7, 5, 7, 5, 7, 5, 7, 5, 7, 5, 7, 5, 7, 5, 7, 5, 7, 5, 7, 5, 7, 5, 7, 5, 7, 3],
    [3, 7, 5, 7, 5, 7, 5, 7, 5, 7, 5, 7, 5, 7, 5, 7, 5, 7, 5, 7, 5, 7, 5, 7, 5, 7, 5, 7, 5, 7, 5, 7, 5, 7, 5, 7, 5, 7, 5, 3],
    [3, 5, 7, 5, 7, 5, 7, 5, 7, 5, 7, 5, 7, 5, 7, 5, 7, 5, 7, 5, 7, 5, 7, 5, 7, 5, 7, 5, 7, 5, 7, 5, 7, 5, 7, 5, 7, 5, 7, 3],
    [3, 7, 5, 7, 5, 7, 5, 7, 5, 7, 5, 7, 5, 7, 5, 7, 5, 7, 5, 7, 5, 7, 5, 7, 5, 7, 5, 7, 5, 7, 5, 7, 5, 7, 5, 7, 5, 7, 5, 3],
    [3, 5, 7, 5, 7, 5, 7, 5, 7, 5, 7, 5, 7, 5, 7, 5, 7, 5, 7, 5, 7, 5, 7, 5, 7, 5, 7, 5, 7, 5, 7, 5, 7, 5, 7, 5, 7, 5, 7, 3],
    [3, 7, 5, 7, 5, 7, 5, 7, 5, 7, 5, 7, 5, 7, 5, 7, 5, 7, 5, 7, 5, 7, 5, 7, 5, 7, 5, 7, 5, 7, 5, 7, 5, 7, 5, 7, 5, 7, 5, 3],
    [3, 5, 7, 5, 7, 5, 7, 5, 7, 5, 7, 5, 7, 5, 7, 5, 7, 5, 7, 5, 7, 5, 7, 5, 7, 5, 7, 5, 7, 5, 7, 5, 7, 5, 7, 5, 7, 5, 7, 3],
    [3, 7, 5, 7, 5, 7, 5, 7, 5, 7, 5, 7, 5, 7, 5, 7, 5, 7, 5, 7, 5, 7, 5, 7, 5, 7, 5, 7, 5, 7, 5, 7, 5, 7, 5, 7, 5, 7, 5, 3],
    [3, 5, 7, 5, 7, 5, 7, 5, 7, 5, 7, 5, 7, 5, 7, 5, 7, 5, 7, 5, 7, 5, 7, 5, 7, 5, 7, 5, 7, 5, 7, 5, 7, 5, 7, 5, 7, 5, 7, 3],
    [3, 7, 5, 7, 5, 7, 5, 7, 5, 7, 5, 7, 5, 7, 5, 7, 5, 7, 5, 7, 5, 7, 5, 7, 5, 7, 5, 7, 5, 7, 5, 7, 5, 7, 5, 7, 5, 7, 5, 3],
    [3, 5, 7, 5, 7, 5, 7, 5, 7, 5, 7, 5, 7, 5, 7, 5, 7, 5, 7, 5, 7, 5, 7, 5, 7, 5, 7, 5, 7, 5, 7, 5, 7, 5, 7, 5, 7, 5, 7, 3],
    [3, 7, 5, 7, 5, 7, 5, 7, 5, 7, 5, 7, 5, 7, 5, 7, 5, 7, 5, 7, 5, 7, 5, 7, 5, 7, 5, 7, 5, 7, 5, 7, 5, 7, 5, 7, 5, 7, 5, 3],
    [3, 5, 7, 5, 7, 5, 7, 5, 7, 5, 7, 5, 7, 5, 7, 5, 7, 5, 7, 5, 7, 5, 7, 5, 7, 5, 7, 5, 7, 5, 7, 5, 7, 5, 7, 5, 7, 5, 7, 3],
    [3, 7, 5, 7, 5, 7, 5, 7, 5, 7, 5, 7, 5, 7, 5, 7, 5, 7, 5, 7, 5, 7, 5, 7, 5, 7, 5, 7, 5, 7, 5, 7, 5, 7, 5, 7, 5, 7, 5, 3],
    [3, 5, 7, 5, 7, 5, 7, 5, 7, 5, 7, 5, 7, 5, 7, 5, 7, 5, 7, 5, 7, 5, 7, 5, 7, 5, 7, 5, 7, 5, 7, 5, 7, 5, 7, 5, 7, 5, 7, 3],
    [3, 7, 5, 7, 5, 7, 5, 7, 5, 7, 5, 7, 5, 7, 5, 7, 5, 7, 5, 7, 5, 7, 5, 7, 5, 7, 5, 7, 5, 7, 5, 7, 5, 7, 5, 7, 5, 7, 5, 3],
    [3, 5, 7, 5, 7, 5, 7, 5, 7, 5, 7, 5, 7, 5, 7, 5, 7, 5, 7, 5, 7, 5, 7, 5, 7, 5, 7, 5, 7, 5, 7, 5, 7, 5, 7, 5, 7, 5, 7, 3],
    [3, 7, 5, 7, 5, 7, 5, 7, 5, 7, 5, 7, 5, 7, 5, 7, 5, 7, 5, 7, 5, 7, 5, 7, 5, 7, 5, 7, 5, 7, 5, 7, 5, 7, 5, 7, 5, 7, 5, 3],
    [3, 5, 7, 5, 7, 5, 7, 5, 7, 5, 7, 5, 7, 5, 7, 5, 7, 5, 7, 5, 7, 5, 7, 5, 7, 5, 7, 5, 7, 5, 7, 5, 7, 5, 7, 5, 7, 5, 7, 3],
    [3, 7, 5, 7, 5, 7, 5, 7, 5, 7, 5, 7, 5, 7, 5, 7, 5, 7, 5, 7, 5, 7, 5, 7, 5, 7, 5, 7, 5, 7, 5, 7, 5, 7, 5, 7, 5, 7, 5, 3],
    [3, 5, 7, 5, 7, 5, 7, 5, 7, 5, 7, 5, 7, 5, 7, 5, 7, 5, 7, 5, 7, 5, 7, 5, 7, 5, 7, 5, 7, 5, 7, 5, 7, 5, 7, 5, 7, 5, 7, 3],
    [3, 7, 5, 7, 5, 7, 5, 7, 5, 7, 5, 7, 5, 7, 5, 7, 5, 7, 5, 7, 5, 7, 5, 7, 5, 7, 5, 7, 5, 7, 5, 7, 5, 7, 5, 7, 5, 7, 5, 3],
    [3, 5, 7, 5, 7, 5, 7, 5, 7, 5, 7, 5, 7, 5, 7, 5, 7, 5, 7, 5, 7, 5, 7, 5, 7, 5, 7, 5, 7, 5, 7, 5, 7, 5, 7, 5, 7, 5, 7, 3],
    [3, 7, 5, 7, 5, 7, 5, 7, 5, 7, 5, 7, 5, 7, 5, 7, 5, 7, 5, 7, 5, 7, 5, 7, 5, 7, 5, 7, 5, 7, 5, 7, 5, 7, 5, 7, 5, 7, 5, 3],
    [3, 5, 7, 5, 7, 5, 7, 5, 7, 5, 7, 5, 7, 5, 7, 5, 7, 5, 7, 5, 7, 5, 7, 5, 7, 5, 7, 5, 7, 5, 7, 5, 7, 5, 7, 5, 7, 5, 7, 3],
    [3, 3, 3, 3, 3, 3, 3, 3, 3, 3, 3, 3, 3, 3, 3, 3, 3, 3, 3, 3, 3, 3, 3, 3, 3, 3, 3, 3, 3, 3, 3, 3, 3, 3, 3, 3, 3, 3, 3, 3]
  ],
  "collision" : []
}