{
    "name": "Nazarek South Object Map",
    "width": 18,
    "height": 20,
    "indices": [
      15, 16, 16, 16, 17,  0,  0, 0, 0, 0, 0, 0, 0, 15, 16, 16, 16, 17,
      25,  0,  0,  0, 27,  0,  0, 0, 0, 0, 0, 0, 0, 25,  0,  0,  0, 27,
      25,  0,  0,  0, 27,  0, 20, 0, 0, 0, 0, 0, 0, 25,  0,  0,  0, 27,
      25,  0,  0,  0, 27,  0,  0, 0, 0, 0, 0, 0, 0, 25,  0,  0,  0, 27,
      25,  0,  0,  0, 27,  0,  0, 0, 0, 0, 0, 0, 0, 25,  0,  0,  0, 27,
      25,  0,  0,  0, 27,  0,  0, 0, 0, 0, 0, 0, 0, 25,  0,  0,  0, 27,
      25,  0,  0,  0, 27,  0,  0, 0, 0, 0, 0, 0, 0, 25,  0,  0,  0, 27,
      25,  0,  0,  0, 27,  0,  0, 0, 0, 0, 0, 0, 0, 25,  0,  0,  0, 27,
      25,  0,  0,  0, 27,  0,  0, 0, 0, 0, 0, 0, 0, 25,  0,  0,  0, 27,
      25,  0,  0,  0, 27,  0,  0, 0, 0, 0, 0, 0, 0, 25,  0,  0,  0, 27,
      25,  0,  0,  0, 27,  0,  0, 0, 0, 0, 0, 0, 0, 25,  0,  0,  0, 27,
      25,  0,  0,  0, 27,  0,  0, 0, 0, 0, 0, 0, 0, 25,  0,  0,  0, 27,
      25,  0,  0,  0, 27,  0,  0, 0, 0, 0, 0, 0, 0, 25,  0,  0,  0, 27,
      25,  0,  0,  0, 27,  0,  0, 0, 0, 0, 0, 0, 0, 25,  0,  0,  0, 27,
      25,  0,  0,  0, 27,  0,  0, 0, 0, 0, 0, 0, 0, 25,  0,  0,  0, 27,
      25,  0,  0,  0, 27,  0,  0, 0, 0, 0, 0, 0, 0, 25,  0,  0,  0, 27,
      25,  0,  0,  0, 27,  0,  0, 0, 0, 0, 0, 0, 0, 25,  0,  0,  0, 27,
      25,  0,  0,  0, 27,  0,  0, 0, 0, 0, 0, 0, 0, 25,  0,  0,  0, 27,
      25,  0,  0,  0, 27,  0,  0, 0, 0, 0, 0, 0, 0, 25,  0,  0,  0, 27,
      35, 36, 36, 36, 37,  0,  0, 0, 0, 0, 0, 0, 0, 35, 36, 36, 36, 37
    ],
    "collision" : [
        1, 1, 1, 1, 1, 0, 0, 0, 0, 0, 0, 0, 0, 1, 1, 1, 1, 1,
        1, 0, 0, 0, 1, 0, 0, 0, 0, 0, 0, 0, 0, 1, 0, 0, 0, 1,
        1, 0, 0, 0, 1, 0, 1, 0, 0, 0, 0, 0, 0, 1, 0, 0, 0, 1,
        1, 0, 0, 0, 1, 0, 0, 0, 0, 0, 0, 0, 0, 1, 0, 0, 0, 1,
        1, 0, 0, 0, 1, 0, 0, 0, 0, 0, 0, 0, 0, 1, 0, 0, 0, 1,
        1, 0, 0, 0, 1, 0, 0, 0, 0, 0, 0, 0, 0, 1, 0, 0, 0, 1,
        1, 0, 0, 0, 1, 0, 0, 0, 0, 0, 0, 0, 0, 1, 0, 0, 0, 1,
        1, 0, 0, 0, 1, 0, 0, 0, 0, 0, 0, 0, 0, 1, 0, 0, 0, 1,
        1, 0, 0, 0, 1, 0, 0, 0, 0, 0, 0, 0, 0, 1, 0, 0, 0, 1,
        1, 0, 0, 0, 1, 0, 0, 0, 0, 0, 0, 0, 0, 1, 0, 0, 0, 1,
        1, 0, 0, 0, 1, 0, 0, 0, 0, 0, 0, 0, 0, 1, 0, 0, 0, 1,
        1, 0, 0, 0, 1, 0, 0, 0, 0, 0, 0, 0, 0, 1, 0, 0, 0, 1,
        1, 0, 0, 0, 1, 0, 0, 0, 0, 0, 0, 0, 0, 1, 0, 0, 0, 1,
        1, 0, 0, 0, 1, 0, 0, 0, 0, 0, 0, 0, 0, 1, 0, 0, 0, 1,
        1, 0, 0, 0, 1, 0, 0, 0, 0, 0, 0, 0, 0, 1, 0, 0, 0, 1,
        1, 0, 0, 0, 1, 0, 0, 0, 0, 0, 0, 0, 0, 1, 0, 0, 0, 1,
        1, 0, 0, 0, 1, 0, 0, 0, 0, 0, 0, 0, 0, 1, 0, 0, 0, 1,
        1, 0, 0, 0, 1, 0, 0, 0, 0, 0, 0, 0, 0, 1, 0, 0, 0, 1,
        1, 0, 0, 0, 1, 0, 0, 0, 0, 0, 0, 0, 0, 1, 0, 0, 0, 1,
        1, 1, 1, 1, 1, 0, 0, 0, 0, 0, 0, 0, 0, 1, 1, 1, 1, 1
      ]
  }