{
  "name": "Object Map Scene 1",
  "indices": [
    [9, 9, 9, 9, 9, 9, 9, 9, 9, 9, 9],
    [9, 0, 0, 0, 0, 0, 0, 0, 0, 0, 9],
    [9, 0, 0, 0, 0, 0, 0, 0, 0, 0, 9],
    [9, 0, 0, 0, 0, 0, 0, 0, 0, 0, 9],
    [9, 0, 0, 0, 0, 0, 0, 0, 0, 0, 9],
    [9, 0, 0, 0, 0, 0, 0, 0, 0, 0, 9],
    [9, 0, 0, 0, 0, 0, 0, 0, 0, 0, 9],
    [9, 0, 0, 0, 0, 0, 0, 0, 0, 0, 9],
    [9, 0, 0, 0, 0, 0, 0, 0, 0, 0, 9],
    [9, 0, 0, 0, 0, 0, 0, 0, 0, 0, 9],
    [9, 0, 0, 0, 0, 0, 0, 0, 0, 0, 9],
    [9, 9, 9, 9, 9, 8, 9, 9, 9, 9, 9]
    ],
  "collision": [
    [1, 1, 1, 1, 1, 1, 1, 1, 1, 1, 1],
    [1, 0, 0, 0, 0, 0, 0, 0, 0, 0, 1],
    [1, 0, 0, 0, 0, 0, 0, 0, 0, 0, 1],
    [1, 0, 0, 0, 0, 0, 0, 0, 0, 0, 1],
    [1, 0, 0, 0, 0, 0, 0, 0, 0, 0, 1],
    [1, 0, 0, 0, 0, 0, 0, 0, 0, 0, 1],
    [1, 0, 0, 0, 0, 0, 0, 0, 0, 0, 1],
    [1, 0, 0, 0, 0, 0, 0, 0, 0, 0, 1],
    [1, 0, 0, 0, 0, 0, 0, 0, 0, 0, 1],
    [1, 0, 0, 0, 0, 0, 0, 0, 0, 0, 1],
    [1, 0, 0, 0, 0, 0, 0, 0, 0, 0, 1],
    [1, 1, 1, 1, 1, 1, 1, 1, 1, 1, 1]
    ]
}